0000000000000000000000000000000000000000000000000000000000000000000000
0000000000000000000000000000000000000000000000000000000000000000000000
0000000000000000000000000000000000000000000000000000000000000000000000
0000000000000000000000000000000000000000000000000000000000000000000000
0000000000000000000000000000000fd0000000000000000000000000000000000h00
000000000000000000000000000c000000000c0000feeed0000feeed0000fee1111111
0000000000000000000000000000000000000000000000000000000000000004222222
0000000000000000000000fd0000000000000000000000000000000000000004222222
0000000000000000000000000000000000000000000000000000000000000004222222
000000000000000000000000000feeed0000fd00000000000000000000000004222222
0000000000000000000000000000000000000000000000000000000000000004222222
00000000000000000000000000000000000000000c000000i00j000000000004222222
0000000000000000000000000000000000000000000005119005119000000004222222
000000000000000000000000000000000000000000005722800422b900000004222222
00000000000000000g0000k0k0000k0k0000k0k0000572228004222b90g00g04222222
00000000000000511111190005119000511900051117222280042222b1111117222222
0h00000511111172222228000422800042280004222222228004222222222222222222
1111111722222222222228000422800042280004222222228004222222222222222222
2222222222222222222228000422800042280004222222228004222222222222222222
2222222222222222222228000422800042280004222222228004222222222222222222
2222222222222222222228000422800042280004222222228004222222222222222222
