000000000000000000000000000000000000000000000000000000000000000000000000000
000000000000000000000000000000000000000000000000000000000000000000000000000
000000000000000000000000000000000000000000000000000000000000000000000000000
000000000000000000000000000000000000000000000000000000000000000000000000000
0000000000000000000000000000000fd000000000000000000000000000000000000000000
000000000000000000000000000c000000000c0000feeed0000feeed0000fee111111111111
000000000000000000000000000000000000000000000000000000000000000422222222222
0000000000000000000000fd000000000000000000000000000000000000000422222222222
000000000000000000000000000000000000000000000000000000000000000422222222222
000000000000000000000000000feeed0000fd0000000000000000000000000422222222222
000000000000000000000000000000000000000000000000000000000000000422222222222
00000000000000000000000000000000000000000c000000000000000000000422222222222
000000000000000000000000000000000000000000000511900511900000000422222222222
000000000000000000000000000000000000000000005722800422b90000000422222222222
0000000000000000000000000000000000000000000572228004222b9000000422222222222
00000000000000511111190005119000511900051117222280042222b111111722222222222
000000051111117222222800042280004228000422222222800422222222222222222222222
111111172222222222222800042280004228000422222222800422222222222222222222222
222222222222222222222800042280004228000422222222800422222222222222222222222
222222222222222222222800042280004228000422222222800422222222222222222222222
222222222222222222222800042280004228000422222222800422222222222222222222222
