0000000000000000000000000000000000000000000000000000000000000000000000
0000000000000000000000000000000000000000000000000000000000000000000000
0000000000000000000000000000000000000000000000000000000000000000000000
0000000000000000000000000000000000000000000000000000000000000000000000
0000000000000000000000000000000000000000000000000000000000000000000000
0000000000000000000000000000000000000000000000000000000000000000000000
0000000000000000000000000000000000feeed0000fd0000000000000000000000000
0000000000000000000000000000000000000000000000000000000000000000000000
000000000000000000000000000000000000000000000000c000000000000000000000
0000000000000000000000000000000000000000000000000000511111119000000000
000000000000000000000000000000000000000000000000000572222222b900000000
0000000000000000000000000000000000000000000000000057222222222b90000000
00000000000000000000051111111111119000511111111111722222222222b1111111
1111111111111111111117222222222222800042222222222222222222222222222222
2222222222222222222222222222222222800042222222222222222222222222222222
2222222222222222222222222222222222800042222222222222222222222222222222
3333333333333333333333333333333333a00063333333333333333333333333333333
