00000000000000000000000000000000000000000000000000000000000000000000000
00000000000000000000000000000000000000fd0000000000000000000000000000000
0000000000000000000000000000000000c000000000c0000feeeed0000feeeeeeeeeee
00000000000000000000000000000000000000000000000000000000000000000000000
00000000000000000000000000000fd0000000000000000000000000000000000000000
00000000000000000000000000000000000000000000000000000000000000000000000
0000000000000000000000000000000000feeed0000fd00000000000000000000000000
00000000000000000000000000000000000000000000000000000000000000000000000
000000000000000000000000000000000000000000000000c0000000000000000000000
00000000000000000000000000000000000000000000000000005119005119000000000
0000000000000000000000000000000000000000000000000005722800422b900000000
00000000000000000000000000000000000000000000000000572228004222b90000000
000000000000000000005111111900051119000511111111117222280042222b1111111
11111111111111111111722222280004222800042222222222222228004222222222222
22222222222222222222222222280004222800042222222222222228004222222222222
22222222222222222222222222280004222800042222222222222228004222222222222
333333333333333333333333333a0006333a0006333333333333333a006333333333333
