000000000000000000000000000000000000000000000000000000000000000000000
000000000000000000000000000000000000000000000000000000000000000000000
000000000000000000000000000000000000000000000000000000000000000000000
000000000000000000000000000000000000000000000000000000000000000000000
000000000000000000000000000000000000000000000000000000000000000000000
000000000000000000000000000000000000000000000000000000000000000000000
000000000000000000000000000000000000000000000000000000000000000000000
000000000000000000000000000000000000000000000000000000000000000000000
000000000000000000000000000000000000000000000000000000000000000000000
000000000000000000000000000000000000000000000000000511111119000000000
00000000000000000000000000000000000000000000000000572222222b900000000
000000000000000000000000000000000000000000000000057222222222b90000000
0000000000000000000005111111111111900511111111111722222222222b1111111
111111111111111111111722222222222280042222222222222222222222222222222
222222222222222222222222222222222280042222222222222222222222222222222
222222222222222222222222222222222280042222222222222222222222222222222
3333333333333333333333333333333333a0063333333333333333333333333333333
