000000000000000000000000000000000000000000000000000000000000000000000000000000000
000000000000000000000000000000000000000000000000000000000000000000000000000000000
000000000000000000000000000000000000000000000000000000000000000000000000000000000
000000000000000000000000000000000000000000000000000000000000000000000000000000000
000000000000000000000000000000000000000000000000000000000000000000000000000000000
000000000000000000000000000000000000000000000000000000000000000000000000000000000
000000000000000000000000000000000000000000000000000000000000000000000000000000000
000000000000000000000000000000000000000000000000000000000000000000000000000000000
000000000000000000000000000000000000000000000000000000000000000000000000000000000
000000000000000000000000000000000000000000000000000000000000000000000000000000000
000000000000000000000000000000000000000000000000000000000000000000000000000000000
000000000000000000000000000000000000000000000000000000000000000000000000000000000
000000000000000000000000000000000000000000000000000000000511900000000000000000000
000000000000000000000000000000000000000000000000000j00005722b900000000000000g00h0
0000000000000000000000000000000000000000000000000k05111172222b1111900000005111111
000000005111119000000000000000000000000000051111900422222222222222b11111117222222
00000005722222b9000000000000000k0000k0k000572222800422222222222222222222222222222
111111172222222b11111900051190005119000511722222800422222222222222222222222222222
222222222222222222222800042280004228000422222222800422222222222222222222222222222
222222222222222222222800042280004228000422222222800422222222222222222222222222222
222222222222222222222800042280004228000422222222800422222222222222222222222222222
